Adapes==sepeda
Adapes rotom==sepeda motor
Ambek==dengan
Apais==siapa
Amrin==pacar
Aranjep==penjara
Arema==Arek Malang
Arodam / Arudam==Madura
Asaib==biasa
Asrob==minum
Atrakaj==Jakarta
Atret==mundur
Aud==dua
Agit==tiga
Ayabarus==Surabaya
Ayas==saya
Ayem==melempem
Ayak==kaya
Anjag / genjes==ganja
Arados==saudara
Awasiham==mahasiswa
Analet==celana
Abakron==narkoba
Astep==pesta
Asales==selasa
Aisur / airus==Rusia
Alanet==celana
Aranet==tentara
Amalatok==kota lama
Balbalan==sepak bola
Balon / Nolab==pelacur
Bes==ebes
Cik==ungkapan 'betapa' atau 'lebih'
Cikno==biarkan
Ciwe==weci
Dewor==wedok, wanita, perempuan
Dhulin==main
Dhudhuk==bukan
Disjam==masjid
Ebes==ebes
Ebes kanal==bapak
Ebes kodew==ibu
Enem==enam
Embong==jalan
Ewed==sendiri
Ewedan==sendirian
Ewag==untuk
Etak==akan
Ewus==lama
Ewul==lapar
Emar==ramai
Elawes==sebelas
Etas==sate
Gak==tidak
Gak neam==tidak beres, tidak becus
Genaro==orang
Ganok / genok==tidak ada
Gelek==sering
Gocik==penakut
Halak==kalah
Hailuk==kuliah
Halokes==sekolah
Hamur==rumah
Hamur tikas==rumah sakit
Hantum==muntah
Hedeg==besar
Helob==boleh
Helos==soleh
Helum==pulang
Hewod==bibir tebal
Holopes / hulupes==sepuluh
Helom==pulang
Hebak==semua
Henem==lagi
Hangates==setengah
Hawas==sawah
Haliuk / haikul==kuliah
Hitup==putih
Ibar==nikah
Idrek==pekerjaan singkatan dari Kerja Rodi era Belanda
Iko==itu
Ilep==penis
Imblak==baju, pakaian
Itreng==paham
Ipes==sepi
Ibab==babi
Ipat==tapi
Irub==belakang
Ingeb==malam
Itor==roti
Itor ngirek roti kering
Igel==manis
Igur==rugi
Ires==seri
Ipok==kopi
Isak==beri
Diisaki diberi
Isruk==kursi
Ispurok==korupsi
Ilab==Bali
Ikejer==rejeki
Iwak==Gunung Kawi
Ijak==Haji
Inareb==berani
Itreng==mengerti, paham
Ja'ik==penekanan kata-kata
Jancik==umpatan agak halus
Jancok==umpatan kasar
Jes==panggilan ke teman
Kawab==bawa
Dikawab dibawa
Kadit==tidak
Kadit reken==biarin
Kadit nes==tidak enak, sombong, gaya
Kampes==celana dalam
Kana==anak
Kanyab==banyak
Kanyab tulum==banyak omong
Kawapan==PSK
Keat==tai
Kelem==terjaga
Keleman bersama teman tidak tidur
Kendho==bodoh
Kenthu==sex
Ker==panggilan teman, rek, arek
Kera==orang
Ketam==mati
Kewut==tua
Kimpet==vagina
Kipa==baik
Kiwal==balik
Kiwalan==terbalik
Kodew==perempuan
Kodew kawaban==wanita bawaan
Koen==kamu
Koleng==mabuk
Koyes==menipu
Kubam==mabuk
Kunam==burung
Kenob==bonek
Kilab==pulang
Kendep==pendek
Kanyup==punya
Kane==enak
Kapes olab==sepak bola
Katab==Batak
Katub==botak
Kolem==ikut
Kopram==rampok
Komes==bahenol
Kida==adik
Kemblas==hilang
Kojop==pojok
Ketep==ayam
Kombet==tembok
Kojom==mojok
Kopit==cipok
Kopit==cium
Kopitan berciuman
Kotrik==perempuan, wanita
Kowab==bawok, alat kelamin wanita
Kusam==masuk
Ladub==berangkat
Landas==sandal
Lancap==tenang, mengayuh sepeda
Lanek==kenal
Latab==batal
Lajeg==jegal
Lawed / lawet==jual
Langgat==tanggal
Laham==mahal
Lab-laban==bermain sepakbola
Lecep==pecel
Lentip==pentil
Leket==memegang
Ledom==gaya
Ledome==gayanya
Leges / lego==jual
Lesek==capek, menyebalkan
Lekes==kaki
Legot==togel
Libom==mobil
Licek==kecil
Likis==kaki
Lites / setil==keren
Lop==penuh
Londem==mendol
Lokop / lukup==pukul, tempeleng
Lotob==botol
Lontok==alat kelamin pria
Lip==pil
Lip nates==pil setan
Lukim==mikul
Lubak==cabul
Main==bermain, becus
Meleg==mau
Menclek==gila
Mengong==bego, gila
Memes==mama, ibu
Nahelop==Polehan
Nenjap==Panjen
Neam==main, becus
Nema==ngamen
Nakam / naskim==makan
Nakaman==makanan
Nawak==kawan
Nawak ewed==kawan sendiri
Nawak letek==kawan dekat
Naisak==kasihan
Nokat==bertanya
Nayamul==lumayan
Nangkus==segan, sungkan
Najat==jajanan, makanan ringan
Ngalam==Malang
Ngalup==pulang
Nganal==laki-laki
Nganem==menang
Ngarames==Semarang
Ngayambes==sembahyang, sholat
Ngarambes==terserah
Ngentit==mencuri
Ngetem==hamil
Ngesop==pusing, jengkel, kesal
Ngingub==bingung
Ngoceb==waria
Ngokob==bokong
Nolek==kelon, tidur bareng
Niliki==mencicipi
Nisak==Kasin
Nyelang==meminjam
Nuwus==Terima kasih
Ngenem==diam
Ngenes==seneng
Nesep==pesen
Ngirip==piring
Nekapan==pakaian
Nalub==bulan
Najad==jajan
Nakus==sungkan
Ngincek==kencing
Ngerom==marah
Ngerom-ngerom==marah-marah
Ngotop==potong
Norak==koran
Ngerog==goreng
Ngatu==utang
Ngurus==dorong
Ngudeg==gedung
Nendes==bersandar
Nendes kombet==bersandar pada tembok
Namulis==siluman
Ngabul==lubang
Nolab==pelacur
Naragod==juragan
Ngilam==maling
Ngipok==minum kopi
Nijar==rajin
Ngombos==sombong
Ngendeg==gila
Neha-neha==aneh-aneh
Niwak==kawin
Narapas==sarapan
Narawep==perawan
Narubuk==kuburan
Nes==enak
Oplok==kelapa
Odop==sama-sama
Oges==nasi
Ojir==uang
Ojob==suami, istri, pacar
Ojrit==iya
Omil==lima
Ongis==singa
Onosogrem==Mergosono
Odhnol==londho
Osed==desa
Onet / onit==Cina
Orip==berapa
Oskab==bakso
Osob==bahasa
Osob kiwalan==bahasa terbalik
Osi==bisa
Oker==rokok
Otos==soto
Otop==Foto
Owik==kiri
Owod==panjang
Oyi==iya
Ocom==membaca
Ongul==pergi
Ongos==sembilan
Onosogrem==Mergosono
Orapes==separuh
Okoren==neraka
Odum==telanjang
Odiar==radio
Opos==siapa
Ogum-ogum==moga-moga
Papat==empat
Plembungan==balon
Prei==libur, tidak mau
Rajajowas==Sawojajar
Raijo==uang
Rudit==tidur
Rabak==kabar
Rontak==kantor
Rikip==pikir
Reneb==benar
Regeg==geger, bertengkar
Rekem==Mikir
Rinjab==banjir
Rasap==pasar
Ratig==gitar
Runcap==campur
Rubus==subur
Rintep==pintar
Raseb==besar
Randub==bundar
Raulek==keluar
Rayab==bayar
Rambag==gambar
Rayub==buyar, selesai
Rayup==terjual, laku
Rebung==mengejar
Randab udad==bandar dadu
Randab legot==bandar togel
Rukus==bersyukur
Racap==pacar
Ringgip==pinggir
Reskon==konser
Ranya==baru
Rondes==janda
Rubub==bubur
Rulet==telur
Rasak==kasar
Sam==kakak laki-laki / laki-laki yang lebih tua
Saleb==sebelas
Saleg==gelas
Sedeb==monyet
Silup==polisi
Sinam==manis
Sanap==panas
Surungep==pengurus
Sak nyukan==sebentar
Sulem==mulas
Senjem==menjes
Setak==pepaya
Seweng==Ngewes, mabuk-mabukan
Sutar==ratus
Singan==nangis
Simak / simek==kamis
Sunim==minus
Salek==kelas
Sagutep==petugas
Sicrak==karcis
Semlohe==sexy
Sareb==beras
Sotam==matos
Soak==baju kaos
Sibun==habis
Sikim==pisau
Tahes==sehat
Tahil / tail==lihat
Takis==ambil, rebut
Tenyom==monyet
Teles==dubur
Tewur==kacau
Tarus==surat
Tarus rabak==surat kabar
Tukis==sikut
Tukis-tukisan==sikut-sikutan
Talarem==melarat
Tapuk==kupat
Tapukan kupatan
Toper==repot
Tungteng==ngentut, kentut
Tikas==sakit
Tekok==dari
Tenclem / tencrem==mencret
Tenges==buang air besar
Tukat==takut
Tanus==sunat
Tanggim==minggat
Tidem==pelit
Tilep==curi, kikir
Tawasep==pesawat
Todep==putus
Tendem==Wendit
Tekes==lima puluh
Todes==Sedot
Tumbej==rambut kemaluan
Ubab==babu, pembantu rumah tangga
Ublem==masuk
Ujut==tujuh
Uklam==berjalan
Uklam-uklam jalan-jalan
Ukut==beli
Umak==kamu
Unyap==punya
Utem==metu
Ujep==Sp3rma
Utas==satu
Utab==Batu
Uhat==tahu
Uhat sitep==tahu petis
Ujab==baju
Ulem / umel==gemuk
Umel kendep==gemuk pendek
Unggim==Minggu
Ubir==ribu
Utup==cucu
Uya==ayu
Urab==baru
Urug==guru
Ujam==maju
Umli==ilmu
Uanis==belajar
Utapes==sepatu
Usus==susu
Ukub==buku
Uleng==pusing
Uyap==sudah terjual, laku
Wanyik==dia, kata ganti wanita
Wanyok==dia, kata ganti pria
Wancik==kata umpatan
Wahdoh==terlanjur terjadi
Wolu==delapan
Ngalam kipa, kota apik lan asri==Malang indah, kota bagus dan bersih
Tamales sam, umak wes lulus ujian==Selamat mas, kamu sudah lulus ujian
Oyi sam, ayas siap nganggo baju anyar==Iyo mas, saya siap pakai baju baru
Tamanges bro, umak iso ngalahno musuh==Semangat bro, kamu bisa mengalahkan musuh
Nayamul nih es krimne, kane lan seger==Lumayan nih es krimnya, enak dan segar
Ayas ewul nih, ayo nakam yuk!==Saya lapar nih, ayo makan yuk!
Umak kipa banget, ayas suka lihat senyummu==Kamu cantik sekali, saya suka lihat senyumanmu
Ewul gak? Nakam dulu sana biar kuat==Lapar gak? Makan dulu sana biar kuat
Umak kadit itreng apa yang ayas omongno?==Kamu tidak ngerti apa yang saya omongkan?
Nawak ewed nih, umak gak usah takut==Kawan sendiri nih, kamu gak usah takut
Arek Malang wis nggonku ngantuk banget==Anak Malang sudah sangat ngantuk
Aku mboten ngertos kabeh omongane==Aku tidak mengerti semua yang dia katakan
Iki sing kandaen duren iki lembute==Ini durian yang baru dipetik, lembut sekali
Ngguyuun kabarmu, wong Malang?==Maukah kamu memberitahu kabarmu, teman Malang?
Mangan-jan mangan, sing penting kumpul bareng==Makan atau tidak makan, yang penting berkumpul bersama
Cucune liyo-liyo, arek Malang kabeh==Cucunya berbeda-beda, anak Malang semuanya
Seng akeh seng brengseke karo budhaya==Ada banyak yang bertentangan dengan budaya
Sing ngene krungu maleh lali==Yang seperti ini pernah terdengar, malas dilupakan
Sembarang arek arek Malang gelo==Semua anak Malang asyik dan lucu
Sing nggolek duit kaya piring dhakat-dhakit==Yang mencari uang itu seperti mencuci piring dengan bersungguh-sungguh
Sing ngrungok arek Malang mesti taat boso==Yang mendengar anak Malang harus taat berbahasa
Aku wis semoyo, bahaya nek orak-arik tulungannya==Aku sudah lelah, berbahaya jika diganggu
Seng arep piknik, iki mimpine Malang==Yang ingin piknik, mimpi menjadi anak Malang
Sing ngandrit batok, wis ndadekna opo loro loro==Yang bermain api, sudah tahu akibatnya
Wis tak darani nang suwung, sing nipu arek Malang==Sudah kuduga di laptop, yang menipu anak Malang
Ilangne arek Malang, kui keblingerane==Menghilangnya anak Malang, itu keanehan
Seng wes nyambrani apune mesti semangat==Yang sudah mendapat pekerjaan harus semangat
Cuk-mumuk kurang becik, yen dedeku tok pol==Wajahnya kurang enak dilihat, jika adikku seperti dia
Ngganjelno nang kali utek-utek==Mendayungnya di sungai yang dangkal
Seng ayu rupane, njaluk dilebhakne==Yang cantik penampilannya, minta ditirunya
Layang-layangku malah gatem akhire==Layang-layangku malah rusak akhirnya
Nganti batine ngebel-gebel==Sampai usianya bergetar-getar
Apa kabar, decene halusan?==Apa kabar, apa kabar anak muda?
Yen gak kyai, kui duwe petinggene==Jika tidak ada Kyai, ini ada petingannya
Ora sabar kakehan critane rejeki==Tidak sabar banyak cerita rezeki
Iki sepedane dolanan==Ini sepedanya mainan
Koreksi badanmu, rasae enak sekali==Perbaiki postur tubuhmu, terasa sangat nyaman
Kulino aja kabeh enak==Belajar saja semuanya enak
Aku lali iki tempate, bingung==Aku lupa tempat ini, bingung
Nek langsung urusane, mung papat-e==Jika langsung menangani masalahnya, hanya butuh empat langkah
Jarene kenthel, maneh nganti maneh==Kepalanya penat, terus tidur terus
Sing ngandek tibo iki ora arek Malang==Yang datang ke sini bukan anak Malang
Arek Malang sepidik-sepidik, nang krungu teles mangan==Anak Malang serius-serius, katanya sudah makan
Mangan nganti arepe enak==Makan sampai puas
Aku ngono-ngono ae maneh mukune angelika==Aku masih bingung, wajahnya seperti Angelika
Suketane hiyak-hiyuk, kada eling==Omongannya gombal, jangan dipercaya
Kui arek Malang sing tresno mati==Itu anak Malang yang cinta mati-matian
Sing kerjo kaya ditekne opo sing ora arek Malang==Yang bekerja seperti didorong atau tidak anak Malang
Senajan tresnanmu sereman, olehku wani ngakoni==Meskipun cintamu keras kepala, aku berani mengakui
Aku kate yak keki ra ono malah==Aku bilang enggak kesal malah ada
Wis tak durung nganti weruh==Sudah ku lihat sampai puas
Sing lagi bobo, mung digedor==Yang sedang tidur, hanya digedor
Arek Malang prenkus-prengus, wildan nembe snjang==Anak Malang riuh-rendah, Wildan belum juga datang
Akhire tak watu ndherek tangga==Akhirnya aku jatuh tersungkur di tangga
Opo arep hak armada bemo==Mau naik armada bemo
Iki gemene kembang hape untuk awakmu==Ini gara-gara bunga panggilan yang diterima olehmu
Arek Malang iso teko, wis iso barber==Anak Malang bisa membaca, sudah bisa cukur
Wis tak papokke dadine geni==Sudah ku padamkan api nya
Ramene luweh, mung malah ngombe dudu makan==Sambil banyak bicara, malah minum bukan makan
Kowe arep ngombe mau temenan ra?==Mau minum, mau teman nggak?
Arek Malang mandheg==Anak Malang bersêru
Sak lere arek Malang bisa srempet trenggalek==Sesekali anak Malang bisa melenceng ke Trenggalek
Arek Malang ajur-ajuron wong Malang==Anak Malang saling membantu
Mlaku arek Malang sing anteng==Berjalan lah anak Malang yang baik dan tenang
Lewat malam langsung banyu tak celupi==Lewat malam langsung mandi saya
Wis tak sabeti mabuk, nek arep tak tetoni malah kabur==Sudah saya tampar habis mabuk, kalau mau saya kejar malah kabur
Sing due obat meskipun dicelup teles kahanan==Yang punya obat meskipun dicairkan kecil saja
Ngguye ana dedek e nyepam menyan==Sekarang ada adik yang asyik membangi menyan
Sok dermone ngeri-ngerios, candhu wes liwat nglalaku==Sok dermawan seperti ingin dipuji, bantuannya sudah lewat dan tak berguna
Nyurumarami sampe blush-on iki==Mencoba memberi merah pipi
Aku gawe iko wes koyo ngono koyok sing kulingani, ora maen mlayu-mlayu==Aku bekerja keras untukmu tetapi kamu seperti tidak menghargainya, tidak main-main
Sing gowo ojo coco maning wis males arek Malang==Yang memiliki jangan digaruk-garuk, sudah malas anak Malang
Sopir bemo iku terangkan jalan wis rak ono wis nganti orak-arik barak==Sopir bemo ini petunjuk jalan jangan diminta terus sampai sakit perut
Arek Malang isok gawin mebeja, arep-wani tak kambeni==Anak Malang bisa disuruh, mau-berani aku tantang
Tak arepe ngantuk arep bobo==Sudah mengantuk mau tidur
Kowe diare tumindak seneng menyang isih kula sopo==Kamu malah senang mengenal siapa saya
Ora tak kumpulani mung arep kabeh opo ora==Tidak ku kumpulkan hanya sebagian atau tidak sama sekali
Apur, cek yang gelem kue talam bali, mumpung pesenane ra butuh purnama==Nenek, cek yang ingin kue talam bali, selagi pesanan tidak membutuhkan purnama
Sing ngepung, nggonku mung sedikit-sedikit==Yang mendukung, dariku hanya sedikit-sedikit
Butuh pegawe tenaga tetap, wes ora ono==Perlu pekerja tetap, sudah tidak ada
Kebakare mesine ndadek musibah==Karena mesin sampai kebakar sialan
Iki pinter banget wis tak gowone==Ini sangat pintar sampai kena tenggorokanku
Arepe Armen ora kerjo tak beleni batik==Sudah tidak bekerja aku beli batik
Sistem kekerasan sing rega-regane akhire pangeling-peling==Sistem kekerasan yang harganya akhirnya tidak mempan
Arek Malang isok tak godek-godek karo nangklam==Anak Malang bisa kujadikan contoh dengan kebiaakannya
Sing nimpal arep dikubur nganti kebuluran==Yang terjebak ingin dikubur sampai kelaparan
Senajan arek Malang wis tak uwongi, mung tak mulekno==Meskipun anak Malang sudah saya temui, hanya saya akan menanyakan kondisinya
Iki jaring jagoan sing genah e jebul==Ini jaring jagoan yang posisinya berubah
Wis tak akeh maleman saiki tak nglakoni ==Sudah saya lakukan banyak malam ini
Cangkem banyu lungguh netes nang triak trik==Gelombang air bermunculan menetes ke tetes
Kowe ora perduli aku, nanging mung ngomong gelem==Kamu tidak peduli padaku, tapi hanya mau bicara
Sing loro putihan jetis iki bener-bener aduh-uh pisan==Yang kedua kompleks perumahan ini benar-benar rumit sekali
Arek Malang wani teko, nanging ora wani seko==Anak Malang berani membaca, tapi tidak berani menulis
Nikmati arek Malang koyo nyemek dhuwur==Nikmati anak Malang seperti makanan enak
Alon-alon pegat segane, sewandane tumindak==Perlahan tapi pasti berhasil
Mung liwat ngochak uga==Hanya lewat terus juga
Ketaringasane wani kulawangun==Keberaniannya ingin diacungi jempol
Kecuk, loro ateh aku termasuk kemane==Sedikit, dua puluh aku langsung termasuk kemarin
Kaya kacangan anak odok mung liwat cilok==Seperti kacang anak kecil hanya lewat cilok
Sak kalepatan arek Malang arep dadi model==Dari kecerobohan anak Malang ingin jadi model
Suwe ora ono pakondeh==Tua tidak ada yang tahu
Sing benere cepet arep tuku==Yang benar-benar cepat ingin membeli
Apik apik arek Malang nyeluk anak==Bagus bagus anak Malang bekerja keras
Sebet ati ateku pisan==Sungguh hati adik ku keras sekali
Arek Malang koyo ayam mrintihan==Anak Malang seperti ayam tertimpa
Gedhek karo ketok nganti bendhol dhadhol==Berantakan dengan tersungkur sampai terbangun
Sing ngombe mung pas ngguyu==Yang minum hanya sekadar meneguk
Ora arep olahraga, mangan mangan rempelo==Tidak mau olahraga, hanya makan saja berlebihan
Ngguyu-ngguyu sing nggira nglarani lanang==Menyeguk nggira menjalankan tugas laki-laki
Aku nangis-ngisani klambi wit==Aku menangis-ngisahkan pakaian wit yang tidak waras
Sing ora biso manut aturane nganti tak pukuli==Yang tidak bisa mengikuti peraturan sampai saya pukul
Mandudek aweh, kelangan pelitrik==Hape rusak, kehilangan pengisi daya
Berat atiku ngono-ngono teka kiyoto==Berat hatiku begitu lihat Kyoto
Sanging kepenaksringen==Sangat kesal
Aku ngapusi kue wis aku blendhong==Aku menyapu kue sudah aku kerjain
Arek Malang isok petun dek petekahi==Anak Malang bisa dipelihara dengan pendendengan
Sing tak arepi ojo arep wong liwat==Yang saya masak jangan diharapkan orang lain lewat
Koe biso ojo mencu-ceku ora?==Kamu bisa tidak menyela ku?
Podo ngopo kudu adem ngopo, lagi-lagi malah dicatures==Sama saja apa harus adem atau tidak, malah dibuat karikatur
Sing wedi loro sekawan suwe darbe tiga ora ngerteni kemane==Yang sudah dua berteman tua sampai tiga tidak tahu kemana
Arek Malang nek loro ora tuku==Anak Malang jika dua tidak dibeli
Bocah mancik mantan sampun tanggung mandhek==Anak kecil yang lincah, dulu baru pacaran sudah mau menikah
Ora mangan mangan bledhekke bledheko==Tidak makan, malah bergerak-gerak
Tak duduken lantern e lumayan gedhe==Saya tinggikan beca-nya cukup tinggi
Arek Malang isok enggo adaran luwih ora kowe nembe cabe-cabean==Anak Malang bisa dibilang lebih dewasa daripada kamu yang masih cabe-cabean
Senajan untung sing didulur, tetep mimpin kadhangsumbere==Meskipun untung ada yang membantu, tetap pimpin kadang-sumbere
Kekasihku sing iso nyeni tak taksnjang, ayatku miskin dudu gadungan ==Kekasihku yang bisa menghibur aku sampai terkesan,celepku miskin bukan gadungan
Kowe aku anggep tempel, mung ye' iki sopo kulo teken==Kamu aku anggap teman, hanya ya ini siapa saya ngomong
Harus kaya janggelan, yen arep enom malah kabur==Harus keras kepala, jika mau enak malah lari
Aku mesthi seneng nang jaman keri senajan kaya mejejer isinane==Aku pasti senang di zaman dulu meskipun banyak jeritan hatinya
Sebab urip sing gawe prembon kabeh serius-seriusan==Karena hidup yang dipelihara semua serius-seriusan
Aduh timbang ayam golek lebah njoged==Aduh berat sama pusing
Kowe kodhol musuhku wae apal iki==Kamu bodoh ini musuhku saja tahu
Salahing gageh sing ngambati sing agojuk==Salah satu besar yang mengalahkan yang lebih besar
Sing neng duwur ojo pertiko makan==Yang di atas jangan dikira makanan
Sing terandak cangkeme, mung lemeson digawe brem==Yang terjerembap cangkeme, hanya diremas-remas seperti dibuat brem
Opo saudaramu dudu saudaramu==Apa saudaramu bukan saudaramu
Ngelemnenin lambane koyo mangan gathuk di selokan==Mengisyaratkan tubuhnya seperti makan bubur di selokan
Sing dipasidhe ayu-ayu, endahe alon-alon celeng==Yang dipersenjatai manis-manis, diakhir memunculkan babi
Nyawang wulan siji lere pohon pisang tunngel, wakak==Melihat bulan satu di pohon pisang sambil tertawa
Arek Malang arep nduweni nyawang sampeyan==Anak Malang ingin bertemu dengan Anda
Ora usah cedhak ati maneh, iku dudu rejeki==Jangan sedih lagi, itu bukan rezeki
Sing nduweni barengan sanak keluarga ora ana sorangan==Yang memiliki bersama-sama dengan keluarga tidak sendirian
Kedheng-kedhengan ora usah dibakar==Perselisihan tidak usah dibesar-besarkan
Sing arep ndeleng pertigaan di pangkalan==Yang ingin melihat pertigaan di pangkalan
Mikire opo ngene iki, sekarepmu durung jelas==Mikir apa begini, keinginanmu belum jelas
Pules, mesem ngene ora mung kanggo blitar==Pulang, senyum begini bukan hanya untuk Blitar
Sing nangis plintat-plintut ojo disuruh boso==Yang nangis histeris jangan disuruh bicara
Arek Malang kadang-kadang dianggep mbodho==Anak Malang kadang-kadang dianggap bodoh
Aku iso didadakke endhes, kok ra enom-enom bojone ora tanggung-tanggung==Aku bisa dibilang seperti endhes, kok tidak enak anaknya tidak tanggung-tanggung
Sing arep dadakan pulang, mesti maringi kabehé==Yang ingin pulang secara mendadak, harus memberi kabar dulu
Kudu kabeh bengi neng tangise, kabeh dandhang lan isih gampang lelah==Harus selalu malam di tangisinya, semuanya terlalu lelah
Dak mesti ngalap imbalan sing ora pejabat ajeg==Tidak perlu mengharapkan bayaran yang tidak setimpal tak berwaris
Sasare igneng ora bubar ana taunan==Perkembangan tidak terhenti ada perubahan tahunan
Sing arep nyabur mesti mulai nyobet enak bacake panjenengan Amis==Yang ingin mengaduk harus mulai mengaduk sendiri enak membacanya kalau sendiri
Wani ora wani, uwong kang golek menungso diarep ora enomé==Berani atau tidak, orang yang mencari muka tidak sedikitnya
Kepikiran wae gegayuhan képlok ngenani kawekasne==Terpikir saja cukup mencuat tentang masa depannya
Sing takon lenan kabeh kéndhel keparat tumindak==Yang bertanya orang lain semua menyalahkan tindakan
Aku mbok ambek abot karo geni-é sing wani ora wani dianggep ngawur==Saya sekalian hilap dengan peroleh-api yang berani atau tidak dianggap tidak waras
Ngathuk-ngethuk kuthuk, padepo nendrai ketrosan==Mengatuk-atuk tertidur, sampai lupa menepati janji
Unmute dudu mangan pelasan==Menghidupkan suara bukan makanan ringan
Matur nuwun wis ngenesti kanggo opah==Terima kasih sudah memperingati untuk nenek
Sing nggone nganti tutup buku penerjemah e mlinggih==Yang memaksa sampai menutup buku penerjemahnya meninggalkan pekerjaan
Podo wae nangis nganti misah, yen lagi duwe cacat lingkungan==Sama saja nangis sampai berpisah jika lagi ada kerusakan lingkungan
Sing ono ora ditindak digowo-digowo==Yang ada tidak ditindak dilipat-lipat
Ora usah ngancem-ancem, kulo ora gumantung kabisane==Jangan mengancam-ancam, saya tidak tergantung pada akhirnya
Sopo-sopo sing tindak dadi model, yen mau ora penting==Siapapun yang bertindak menjadi model, jika tidak penting
Sing mateni wong lanang bener ngomong selira==Yang membunuh orang sebenarnya bicara sindiran
Wis ketigen kajupuk, pimpinan nggomong ngene ke ulem-balung-an==Sudah ketiga kali dijemput, pimpinan bicara begini ke arah peternakan
Sing kedah gopek mesti sipat wis ra angger==Yang harus lembut harus wataknya tidak lemah
Arek Malang sing gedhe katon ora pancen duwe omong-omongan==Anak Malang yang besar-besar tampaknya tidak punya omongan
Ora usah ngerti tresno, sing penting mandek-lahé==Tidak usah mengerti cinta, yang penting jangan teledor
Pan namune kedumaku jagoat asuransi==Segala keadaan kedua orang tua saya hebat sebagai asuransi
Arek Malang koyo kucing mati, karuan ninggalne==Anak Malang seperti kucing mati, langsung ditinggalkannya
Sing uruté marut tiyang yeyé, aku mesem wae==Yang pengacara-acaranya kusam, saya tersenyum saja
Mung dibungkam enomé bacaring korban==Hanya menyimpan sendiri anaknya memerhatikan korban
Sing tak tinggalake saiki déné ketok manis==Yang saya tinggalkan sekarang ternyata terasa manis
Sing bakal maringin, dodo tekanané==Yang akan menjadi mengetahui tekanannya
Wong wadon sing guna-guna, dudu benar-benar wong wadon==Perempuan yang menggunakan sihir, bukan benar-benar perempuan
Nikmati arek Malang koyo nyusup semangkuk tahu==Nikmati anak Malang seperti menyusup semangkuk tahu
Gedhek wae, turu kuwi dibawah gelagar==Berantakan saja, tidur itu dibawah terpal
Sing deg-degané menanti, tururé jajan sekulit==Yang berdebar-debar menanti, hasilnya cuma sekulit
Arek Malang sing cuwir-cuwir, yen tak cenat-cenut tak pelihara==Anak Malang yang bergelora, jika tak santai-santai saya pelihara
Sing ketigo arep ngajak ngalamion lanjine, yolo==Yang ketiga ingin mengajak berkenalan tetapi malah lari, yolo
Jackpot, penilané udan disebun==Jackpot, keberuntungan diselimuti hujan
Sing wis biso ngilangi jerite lali tak bolosi==Yang sudah bisa menghilangkan jeritan, lupa saya kabosi
Ora usah ngedit-ngedit fakta, aku tetep jujur==Tidak usah mengedit-ngedit fakta, saya tetap jujur
Sing dadi reperaire untung, ora iso mangan lantaran dihemat ombak malah tetap mandhek==Yang jadi nakhoda untung, tidak bisa makan karena dihemat ombak malah tetap hantu ngadem
Akhire bikul ngisep mulut bapa iku Luhan ngene==Akhirnya memukul isi mulut bapa seperti Luhan begini
Suprised aransemené ora benar-benar arangé==Suprised pengaturan tidak benar-benar terbangun
Aku mboten ngerti==Saya tidak mengerti
Arep mangan sing enak-opo?==Mau makan apa yang enak?
Seng stress katanya enek bae==Orang yang stres itu banyak banget ya
Lepas marai dari sing bae malo==Baru saja pulang dari tempat yang jauh
Wis ora dolan==Sudah tidak main
Opo sing arep dadi dolan?==Apa yang ingin kamu jadikan mainan?
Seng nyupir ngelak==Orang yang mengemudi lancar
Sanes muter-muter yo maneh==Sudah putar-putar lagi
Wis soko sekolah==Sudah dari sekolah
Aku arep nggawe lencana==Saya ingin membuat bros
Iki wae mambu==Ini saja yang ada
Makane iku sing wajib==Makanan itu yang wajib
Wes waktune mlungker==Sudah waktunya bekerja keras
Sing enek greja ora dolan==Yang ada gereja tidak main
Nembaki sing jare==Menembak yang jauh
Mlayu rame-rame==Berjalan bersama-sama
Sing arep wis numpak sepeda==Yang ingin naik sepeda
Wis arep numpak jenenge temane==Sudah mau naik mobilnya teman
Coba lihat sing katro==Coba lihat yang hancur itu
Sing ditunggu mboten muncul==Yang di tunggu tidak muncul
Sing arep madang bae arek==Yang ingin mencari anak-anak
Wis bisa nulis nang buku==Sudah bisa menulis di buku
Temane arep mange kue trompet==Teman ingin membeli kue trompet
Cak lemari wis melu==Laci lemari sudah lebar
Nyebut taksa sing bae==Menyebut nama yang benar
Aku wani ngomong ben==Saya berani bicara jujur
Wis time out bareng-bareng==Sudah istirahat bersama-sama
Neng toko iki enek apa?==Di toko ini ada apa?
Wis lewat lambe==Sudah lewat malam
Sing wae wis mambu==Yang itu saja yang ada
Aku seneng banget==Saya sangat senang
Arek iki kuat ngomong==Anak ini pandai bicara
Wis dolan bareng awakmu==Sudah main bersama kamu
Sing enek semangkane artis==Yang ada semangkuk artis
Aku wis dindekne biji sejatine==Saya sudah melihat benih sebenarnya
Opo sing arep diomongke?==Apa yang ingin diucapkan?
Wis kabeh arep enek di foto==Semua ingin ada dalam foto
Wis ngeledek iki==Sudah mempermainkan ini
Wis dinekake olehku==Sudah dilihat oleh saya
Arek iki pancen cetha==Anak ini memang cerdas
Arep dadi sing bae==Mau jadi yang baik
Aku arep ngrusuhi koyo sing liyo==Saya ingin mengganggu seperti yang lain
Lali seng kuat nyolek==Lupakan yang kuat mengejek
Seng kene pancen nangis terus==Orang yang di sana memang sering menangis
Nyekel tekell nang bank==Menabung di bank
Arep nyelengke hilir==Ingin mencuci baju
Arep temu wong sing padhang==Mau bertemu dengan orang pintar
Seng enek wones==Orang yang sudah muncul
Arep kanthi mango milk==Mau dengan mangga susu
Aku wis geprek telekno==Saya sudah menggoreng telur
Seng males arep ngopi==Orang yang malas ingin minum kopi
Sinare-mare wis pada moco==Suasana sudah pada membaca
Iki wae cukup==Ini saja cukup
Arep metu neng pasar sepiro?==Mau keluar ke pasar apa dulu?
Wis kabeh arep ngowahi judhul==Semua ingin mengubah judul
Seng takon terus ora dijawab==Yang bertanya terus tidak dijawab
Aku wis nyekel chips==Saya sudah menggoreng kripik
Mboten dadi nelpon mbahmu==Tidak bisa menelepon nenekmu
Arep sunat next month==Rencana sunat bulan depan
Seng kuat dolanan senapan==Orang yang pandai bermain senapan
Wes klarifikasi opo durung==Sudah klarifikasi atau belum?
Aku arep nggawa kado ulang tahun==Saya ingin membuat hadiah ulang tahun
Seng arep sekolah trep==Orang yang ingin sekolah terus
Sing wae arep mambu==Yang itu saja yang ada
Arek iki ngerti moto-motone==Anak ini paham fotografi
Wis sing gae kripik==Sudah yang membuat kripik
Nembaki e muwa o==Menembak itu mudah
Mboten pengin arep kalah==Tidak ingin kalah
Aku sing dolan opo kok==Saya yang bermain apa ya?
Arek sing biasane arep mangan kasir==Anak yang biasanya ingin makan kaser
Seng enek mesjid uwong==Orang yang ada di masjid
Wis banjir saking hujane==Sudah banjir karena hujan
Nang pasar wis enek sing gaduh==Di pasar sudah ada yang ramai
Arek iki wis pandai kaut==Anak ini sudah pandai menulis
Arep diwegkan nang taman==Mau digiring ke taman
Wis takon kabeh wong sing dut==Sudah saya tanya semua orang yang tahu
Sing arep dugem bareng==Yang ingin nongkrong bareng
Aku arep nengok cat-eye==Saya ingin melihat mata kucing
Wis arep tangi hubungno==Sudah mau menelpon
Sing kono arep mangan wedang jahe==Yang di sini ingin minum wedang jahe
Aku seneng banget==Saya sangat senang
Wis rak takon kang mu==Sudah tak tanya kepada temanmu
Semono wong arep mangan ikan==Semua orang ingin makan ikan
Arep bingung nang pasar==Mau bingung di pasar
Sing arep enek dadi==Yang ingin ada jadi
Aku wis cabut wulu brow==Saya sudah mencabut rambutnya bro
Wis dibolot jare==Sudah ditangkap yang jauh
Wis nggowo kabeh temenku==Sudah pergi dengan semua temanku
Sing enek papan sowan==Yang ada papan ucapan selamat
Arep maem nang warung bu jarwo==Mau makan di warung Bu Jarwo
Aku arep ngedol bantal==Saya ingin menggulingkan bantal
Arep baleni sing liyo==Ingin membeli yang lain
Wes legowo bae==Sudah ikhlas saja
Seng mandi-ae dolan==Orang yang hanya mandi bermain
Ngobrol bareng-bareng==Ngobrol bersama-sama
Arep nanggung salah wae==Mau bertanggung jawab satu saja
Seng arep wis mambu==Orang yang ingin sudah ada
Seng enek warung geprak enek==Orang yang ada warung geprak ada
Arep wis diatur dong==Mau sudah diatur dong
Wis mau lulus perdana==Sudah mau lulus perdana